6
-.H.P.W.-.H
-.-.-.-.-.P
-.H.-.-.-.-
W.G.-.-.P.-
-.-.P.-.H.-
-.-.H.-.W.H