10
-.-.-.-.-.-.-.-.-.-
-.-.P.-.-.-.-.-.-.-
-.-.-.-.W.-.-.-.-.-
-.P_G.-.-.-.-.-.-.-.-
-.-.P_G.-.-.-.-.-.-.-
-.-.-.-.H_P.-.-.-.-.-
-.-.-.P.-.-.-.-.-.-
-.G.-.-.-.-.-.-.-.-
-.-.-.-.-.-.-.-.-.-
-.-.-.-.-.-.-.-.-.-