10
-.-.P.-.-.-.-.-.-.-
-.P.H_P.-.-.-.-.-.-.-
P.-.-.-.-.-.G.-.-.-
P_G.-.-.-.-.-.-.-.-.-
-.-.-.-.-.-.-.-.-.-
-.-.-.-.-.-.-.-.-.-
-.-.-.-.P_G.-.-.-.-.-
P.-.-.-.-.-.-.-.-.-
-.P.-.-.-.-.-.-.P.-
-.-.P.-.-.-.-.-.-.-