10
-.-.P_G.-.-.-.-.-.-.-
-.-.-.-.-.-.-.W.-.-
P.-.-.W.-.-.-.-.-.-
-.-.-.-.-.-.-.-.-.-
-.-.-.-.-.P.-.-.-.-
-.-.-.-.P.G.P.-.-.-
-.-.W.-.-.P.-.-.-.-
-.W.H_P.W.-.-.-.-.-.-
-.-.W.-.-.-.-.-.-.-
-.-.-.-.-.-.-.-.G.-